1111111111111
1000000000001
1000200020001                   1111111111111
1000006000001                  100000000000001
1000003000001                  100011111110001    11
1006000007001                  1000111111100011111111
10060000*7001                  1000000000000000000001
1003444445001                  100000000000000000000111
1000000000001                  100001111111111111000001
1111001111111                  11011            1000001
11110011111111111111111111     11011   111111   1000001
100000000000000000000000011111110001111100001  100000001
101111111110110000000000000000000000000000b01  111111111
101000000010110001000011111111111111111100001     89a
10100122101011000100001                111111     607
10111111101011000111101                           345
10000000001011000200001119999999999999999999999999999999999999a
101111111110110001000000000000000000000000000000000000000000007
1000000000001100000000000899a0000000000000000000000000000000007
11111001111111111111111111  70000000000000000000100000000000007
899990099999a             8450000000000000000000100000000000007
6000000000007             6000000000000000000000000001121100007
6000000000007             60000000000000000000000000000*0000007
6000000000007             6000000000000000000000000000000000007
600dbcdb00007             3444444444444444444444044444444444445
6000000000007                                  101
6000000000007                                  101
6000000000007                                  101
6000000000007                                  101
3444444444445                                  101
                                  1111111111111101111111111111111
                                  1000000000000100000000001000001
                                  1010100111111101111111101011101
                                  1010100100010000111101111010101
                                  1000000100000000111111111010101
                                  11111100011111100000000*0000111
                                  1111111111111111111111111110111
                                                            111